20 20
####################
#......#############
#..#.#.............#
####.###############
#...D..............#
#..................#
#...S..............#
#..................#
#..................#
#........T.........#
#..................#
#..................#
#..................#
#########.##########
#..................#
#..................#
#..................#
#..................#
#..................#
####################
5
Character @ 5 5 ConsoleController 9 9
Character % 2 2 StationaryController 3 4
Greatsword 1 4
Door 4 4 Switch 4 6
Trap 9 9